######## #########
#......###.......#
#..@...|.|...R...#
#......###.......#
######## ####|####
            #.#
            #.#
            #.#
            #.#
            #.#
            #.#
            #.#
#############|##################################
#..............................................#
#..............................................#
#................S.............................#
#............S.................................#
#..............................................#
#.....................S........................#
#..............................................#
#..............................................#
#..............................................#
#..............................................#
#..............................................#
################################################
