##################
#................#
#................#
#........u.......#
##################

