######## #########
#......###.......#
#......|.|.......#
#......###.......#
######## ####|####
            #.#
            #.#
            #.#
            #.#
            #.#
            #.#
            #.#
#############|##################################
#..............................................#
#..............................................#
#..............................................#
#..............................................#
#.........@.................S..................#
#...........................R..................#
#..............................................#
#..............................................#
#..............................................#
#..............................................#
#..............................................#
################################################
