######## #########
#......###.......#
#..P...|.|.......#
#......###.......#
######## ####|####
            #.#
            #.#
            #.#
            #.#
            #.#
            #.#
            #.#
#############|##################################
#..............................................#
#..............................................#
#..............................................#
#..............................................#
#..............................................#
#..............................................#
#..............................................#
#..............................................#
#..............................................#
#..............................................#
#..............................................#
################################################
