######## #########
#......###.......#
#......|.|.......#
#......###.......#
######## ####|####
            #R#
            #.#
            #.#
            #.#
            #.#
            #.#
            #.#
#############|##################################
#..............................................#
#..............................................#
#..............................................#
#..............................................#
#.........@.......d...............S............#
#..............................................#
#.............u.............R..................#
#..............................................#
#..............................................#
#..............................................#
#..............................................#
################################################
